R 600 720
NO img/test1.xpm
SO img/test2.xpm
WE img/test3.xpm
EA img/test4.xpm

S img/sprite.xpm
F 255,228,205
C 0,191,255

1111111111
1000000001111111111
1000000000000000001
1000000001111111101
1000000001      101
1000000001111111101111111111111111111
1000000000000000000000000000000000001
100000000000000000000000000000000N001
1000000000000000000000000000000000001
1111111111111111111111111111111111111
