R 1200 720
NO img/test1.xpm
SO img/test2.xpm
WE img/test3.xpm
EA img/test4.xpm

S img/sprite.xpm
F 255,228,205
C 0,191,255

1111111111
1000000001
1000000001
1000011101
1000010001
10000111011111
10000000000001
10000000000001
10N00000000001
11111111111111
