R 1200 700
NO img/cobblestone.xpm
SO img/stone.xpm
WE img/bricks.xpm
EA img/tile.xpm

S img/bricks.xpm
F 255,228,205
C 0,191,255

1111111111
1000000001111111111
1000000000000000001
1000000001111000101
1000000001  1000101
1000000000111111001111111111111111111
1000000000000000000000000000000000001
10000010000000000W0000000000000000001
1000000000000000000000000000000000001
1111111111111111111111111111111111111
