R 1280 720
NO img/cobblestone.xpm
SO img/stone.xpm
WE img/bricks.xpm
EA img/tile.xpm

S img/sprite_lantern.xpm
F 255,228,205
C 0,191,255

1111111111
1000000000111111111
1000000000000000001
1000000000111000101
10000000001 1000101
1000000000111111001111111111111111111
1000000000000000000000000000000000001
1000001000000000000000000000000000001
1000000000000000000000000000000000001
1111111111111000001111111111111111101
            1000001               101
            1000001               101
            1000001111111111111111101
            1000000000000000000000001
            1000000000000000000000001
1111111111111000000000000000000000001
1000000000000000000010000100000000001
1000000000000000000001001000000000001
1000000000000000000000000000000000001111111111111
1100000000000000000000000000000000000000000000001
 1100E0000000000000000000000000000000000000000001
  11100000000002000000000000000000000000000000001
    111100000000000000000000011111111111111111111
       11111000000000000011111
       1000111110000111111
       1000000011001101
       1000000000000001
       1000000000000001
       1000000000000001
       1111111111111111
