R 800 500
NO img/test1.xpm
SO img/test2.xpm
WE img/test3.xpm
EA img/test4.xpm

S img/sprite.xpm
F 220,100,0
C 225,30,0

1111111111
1000010001
1000000001
1000000001
100000000111111
100000000000001
1000N0000000001
100000000000001
100000000000001
111111000111111
     10001
     10001
     10001
     11111
