R 1200 700
NO img/cobblestone.xpm
SO img/stone.xpm
WE img/bricks.xpm
EA img/tile.xpm

S img/sprite.xpm
F 255,228,205
C 0,191,255

1111111111
1000000001111111111
1000000000000000001
1000000001111000101
1000000001  1000101
1000000000111111001111111111111111111
1000000000000000000000000000000000001
10000010000200000W0000000000000000001
1000000000000000000000000000000000001
1111111111111000001111111111111111101
            1000001               101
            1000001               101
            1000001111111111111111101
            1000000000000000000000001
            1000000000000000000000001
1111111111111000000000000000000000001
1000000000000000000000000000000000001
1000000000000000000000000000000000001
1000000000001110000000000111000000001
1000000000001 100000000001 1000000001
1111111111111 111111111111 1111111111
