R 1000 600
NO img/cobblestone.xpm
SO img/stone.xpm
WE img/bricks.xpm
EA img/tile.xpm

S img/sprite_barrel.xpm
F 255,228,205
C 0,191,255

1111111111
1000000021111111111
1020000000000000001
1000000001111000101
1000000001  1000101
1000000000111111201111111111111111111
1000000000200000000000000222200000001
1020001000000000000000000000000000001
1000000000200000000000000222200000001
1111111111111000001111111111111111101
            1000001               101
            1000001               101
            1000001111111111111111101
            1000000000000000000000001
            1000000000000000000000001
1111111111111000000000000000000000001
1000000000000000000012002100000000001
1000000000000000000021001200000000001
10000000000000E0000000000000000000001
1100000000000000000000000000000000011
 11000000000000000000000000000000011
  111000000000020000000000000000111
    11110000000000000000000001111
       11111000000000000011111
           111110000111111
               111111
