R 2000 780
NO img/cobblestone.xpm
SO img/stone.xpm
WE img/bricks.xpm
EA img/tile.xpm

S img/sprite_barrel.xpm
F 255,228,205
C 0,191,255

11111111111111111111111111
10000000000000000000000001
10002222222222000000000001
10002222222222000000000001
10002222222222000000000001
10002222222222000000000001
10002222222222000000000001
10002222222222000000000001
10002222222222000000000001
10002222222222000000000001
10002222222222000000000001
10002222222222000000000001
10000000000000000000000001
10000000000000000000000001
10000000000000000000000001
10000000000000000000000001
10000000000000N00000000001
11111111111111111111111111
